7 12
wwwwwwwwwwwwwwww
w##############w
w###d######d###w
w##**********##w
w##**********##w
w##**********##w
w*****####*****w
w****##bb##****w
w****#bbbb#****w
w****##bb##****w
w*****####*****w
w**************w
w&&&&&&&&&&&&&&w
w&&&&&&&&&&&&&&w
w&&&&&&&&&&&&&&w
wwwwwwwwwwwwwwww

0000000000000000
0000000000000000
0000100000010000
0001111111111000
0001111111111000
0001111111111000
0111110000111110
0111100110011110
0111101111011110
0111100110011110
0111110000111110
0111111111111110
0111111111111110
0111111111111110
0111111111111110
0000000000000000

0000000000000000
0000000000000000
0000300000020000
0000000000000000
0000000000000000
0000000000000000
0000000000000000
0000000000000000
0000000000000000
0000000000000000
0000000000000000
0000000000000000
0000000000000000
0000000000000000
0000000000000000
0000000000000000

0000000000000000
0000000000000000
0000000000000000
0000000000000000
0000000b00000000
0000000000000000
0000000000000000
000b00000000b000
0000000000000000
0000000000000000
0000000000000000
000e0000000e0000
0000000000000000
0000000000000000
0000000000000000
0000000000000000