3 12

wwwwwwwwwwwwwwww
w##############w
w#**#bbbbbb#**#w
w#**#bbbbbb#**#w
w#***######***#w
w#************#w
w#************#w
w#************#w
w#************#w
w#************#w
w#************#w
w#************#w
w#************#w
w##d###########w
wwwwwwwwwwwwwwww
wwwwwwwwwwwwwwww

0000000000000000
0000000000000000
0011011111101100
0011011111101100
0011100000011100
0011111111111100
0011111111111100
0011111111111100
0011111111111100
0011111111111100
0011111111111100
0011111111111100
0011111111111100
0001000000000000
0000000000000000
0000000000000000

0000000000000000
0000000000000000
0000000000000000
0000000000000000
0000000000000000
0000000000000000
0000000000000000
0000000000000000
0000000000000000
0000000000000000
0000000000000000
0000000000000000
0000000000000000
0001000000000000
0000000000000000
0000000000000000

0000000000000000
0000000000000000
0000000000000000
0000000000000000
0000000000000000
0000000000000000
0000b00b00b00000
0000000000000000
0000000000000000
0000000000000000
000000e000e00000
0000000000000000
0000000000000000
0000000000000000
0000000000000000
0000000000000000
