12 12

wwwwwwwwwwwwwwww
w##############w
w#b#********#b#w
w###****b***###w
w#************#w
w#*b**********#w
w#************#w
w#*******b****#w
w#************#w
w#************#w
w#***********b#w
w#***b********#w
w###**********#w
w#b#**********#w
w###########d##w
wwwwwwwwwwwwwwww

0000000000000000
0000000000000000
0010111111110100
0000111111110000
0011111111111100
0011111111111100
0011111111111100
0011111111111100
0011111111111100
0011111111111100
0011111111111100
0011111111111100
0000111111111100
0010111111111100
0000000000001000
0000000000000000

0000000000000000
0000000000000000
0000000000000000
0000000000000000
0000000000000000
0000000000000000
0000000000000000
0000000000000000
0000000000000000
0000000000000000
0000000000000000
0000000000000000
0000000000000000
0000000000000000
0000000000001000
0000000000000000

0000000000000000
0000000000000000
0000000000000000
0000000000000000
0000000e00000000
0000000000000000
00000000000e0000
0000e00000000000
0000000000000000
000000e000000000
00000000000e0000
0000000000000000
0000000000000000
0000000000000000
0000000000000000
0000000000000000